31
23
51 51 51 51 51 52 0 0 0 0 0 0 0 0 0 0 0 0 0 0 0 0 0 0 0 0 50 51 51 51 51 
51 51 51 51 51 52 0 0 0 3 0 0 3 0 0 0 0 0 0 0 0 0 0 0 0 0 50 51 47 51 51 
51 51 47 51 47 52 0 0 48 41 0 0 41 49 0 0 0 0 0 0 0 0 0 0 0 0 50 51 51 51 51 
51 51 51 51 51 52 0 0 50 51 0 0 51 52 0 0 2 0 0 0 0 0 0 0 0 0 50 51 51 51 51 
51 51 51 51 51 52 0 0 50 47 0 0 51 52 48 41 41 41 49 0 0 0 0 0 0 0 50 51 47 51 51 
51 47 51 51 51 52 0 0 50 51 0 0 51 52 50 51 51 51 52 0 0 0 0 0 0 0 50 51 51 51 51 
51 51 51 51 51 52 0 0 50 51 0 0 47 52 50 51 47 51 52 0 0 0 0 0 0 0 50 51 51 51 47 
51 51 51 47 51 52 0 0 50 51 0 0 51 52 50 51 51 51 52 0 0 0 0 0 0 0 50 47 51 51 51 
51 51 51 51 51 52 0 0 50 51 0 0 51 52 50 51 51 51 52 4 5 5 5 5 6 0 50 51 51 51 51 
51 51 51 51 51 51 40 40 40 45 0 0 43 41 41 41 41 41 41 41 41 41 41 41 41 41 51 51 51 51 51 
51 47 47 51 51 51 51 51 51 52 0 0 50 51 51 51 51 51 51 51 51 51 51 51 51 51 51 51 51 51 51 
51 51 51 51 51 51 51 51 51 52 0 0 50 47 51 51 51 51 51 51 47 51 51 51 51 51 51 51 51 51 51 
51 51 51 51 51 51 47 51 51 52 0 0 50 51 51 51 51 47 51 51 51 51 51 51 51 51 47 51 51 51 51 
51 51 47 51 51 51 51 51 51 52 0 0 50 51 51 51 51 51 51 51 51 51 47 51 51 51 51 51 51 51 51 
51 51 51 51 51 51 51 51 51 52 0 0 50 51 51 51 51 51 51 51 51 51 51 51 51 51 51 51 51 51 51 
51 51 47 51 51 51 69 70 70 71 0 0 69 70 71 51 51 51 51 51 51 51 51 51 51 51 51 51 51 51 51 
51 47 51 51 51 47 0 0 0 0 0 0 0 0 0 51 51 51 51 51 47 51 51 51 51 47 51 51 51 51 51 
51 47 47 51 51 47 0 0 0 0 0 0 0 0 0 51 51 51 51 51 51 51 51 51 51 51 51 51 47 51 51 
51 51 51 51 51 51 0 0 0 0 0 0 0 0 0 51 51 51 51 51 51 51 51 51 51 51 51 51 51 51 51 
51 47 51 51 51 51 44 44 44 44 44 44 44 44 44 51 51 51 51 51 51 51 51 51 51 51 51 51 51 51 51 
51 51 51 51 47 51 51 51 51 51 51 51 51 51 51 51 51 51 51 47 51 51 51 51 51 51 47 51 47 51 51 
51 51 51 51 51 51 51 51 51 47 51 51 51 51 47 51 51 51 51 51 51 51 51 51 51 51 51 51 51 51 51 
51 51 51 51 51 51 51 51 51 51 51 51 51 51 51 51 51 51 51 51 51 51 51 51 51 51 51 51 51 51 51 
