29
19
51 51 52 0 0 0 0 0 0 0 0 0 0 0 0 0 0 0 0 0 0 0 0 0 0 0 0 0 0 
51 51 52 0 0 0 0 0 0 0 0 0 0 0 0 0 0 0 0 0 0 0 0 0 0 0 0 0 0 
51 51 52 0 0 0 0 0 0 0 0 0 0 0 0 0 0 0 0 0 0 0 0 0 0 0 0 0 0 
51 51 52 0 0 0 0 0 0 0 0 0 0 0 0 0 0 0 0 0 0 0 0 0 0 0 0 0 0 
51 51 52 0 0 0 0 0 0 0 0 0 0 0 0 0 0 0 0 0 0 0 0 0 0 0 0 0 0 
51 51 52 0 0 0 0 0 0 0 0 0 0 0 0 0 0 0 0 0 0 0 0 0 0 0 0 0 0 
51 51 52 0 0 0 0 0 0 0 0 0 0 0 0 0 0 0 0 0 0 0 0 0 0 0 0 0 0 
51 3 52 0 0 0 0 0 0 0 0 0 0 0 0 0 0 0 0 0 0 0 0 0 0 0 0 0 0 
51 51 52 0 0 0 0 0 0 0 0 0 0 0 0 0 0 0 0 0 0 0 0 0 0 0 0 0 0 
51 51 52 0 0 0 0 68 0 0 0 0 0 0 0 0 0 0 0 0 0 0 0 0 0 0 0 0 0 
51 51 52 0 2 0 0 68 0 0 0 0 0 0 0 0 0 0 0 0 0 0 0 0 0 0 0 0 0 
51 51 52 0 43 44 44 44 44 44 45 0 0 68 0 0 0 0 0 0 0 0 0 0 0 0 0 0 0 
51 51 52 0 50 47 51 51 51 51 52 43 41 41 42 45 0 0 0 0 0 0 0 0 0 0 0 0 0 
51 51 52 0 50 51 51 51 51 51 52 50 51 51 51 52 0 0 0 0 0 0 0 0 3 0 0 0 0 
51 51 41 42 44 44 40 41 41 41 41 41 41 41 41 42 44 41 41 41 41 41 41 41 41 41 41 41 0 
51 51 47 51 51 51 51 51 51 51 51 47 51 51 51 51 51 51 51 51 51 51 51 51 51 51 51 51 0 
51 51 51 51 51 51 51 51 47 51 51 51 51 51 51 51 51 47 51 47 47 51 51 51 51 47 51 51 51 
51 51 51 47 51 51 51 51 51 51 51 47 51 51 47 51 51 51 51 51 51 51 51 51 51 51 51 51 51 
51 51 51 51 51 51 51 51 51 51 51 51 51 51 51 51 51 51 51 51 51 47 47 51 51 51 51 51 51 
