43
23
51 51 51 52 0 0 0 0 0 0 0 0 0 0 0 0 0 0 0 0 0 0 0 0 0 0 0 0 0 0 0 0 0 0 0 0 0 0 0 0 50 51 51 
51 51 51 52 0 0 0 0 0 0 0 0 0 0 0 0 0 0 0 0 0 0 0 0 0 0 0 0 0 0 0 0 0 0 0 0 0 0 0 0 50 51 47 
51 51 51 52 0 0 0 0 0 0 0 0 0 0 0 0 0 0 0 0 0 0 0 0 0 0 0 0 0 0 0 0 0 0 0 0 0 0 0 0 50 51 51 
51 47 47 52 0 0 0 0 0 0 0 0 0 0 0 0 0 0 0 0 0 0 0 0 0 0 0 0 0 0 0 0 0 0 0 0 0 0 0 0 50 47 51 
51 51 51 52 0 0 0 0 0 0 0 0 0 0 0 0 0 0 0 0 0 0 0 0 0 0 0 0 0 0 0 0 0 0 0 0 0 0 0 0 50 51 51 
51 51 51 52 0 0 0 0 0 0 0 0 0 0 0 0 0 0 0 0 0 0 0 0 0 0 0 0 0 0 0 0 0 0 0 0 0 0 0 0 50 51 51 
47 51 51 52 0 0 0 0 0 0 0 0 0 0 0 0 0 0 0 0 0 0 0 0 0 0 0 0 0 0 0 0 0 0 0 0 0 0 0 0 50 51 51 
51 51 51 52 0 0 0 0 0 0 0 0 0 0 0 0 0 0 0 0 0 0 0 0 0 0 0 0 0 0 0 0 0 0 0 0 0 0 0 0 50 51 51 
51 51 51 52 0 0 0 0 0 0 0 0 0 0 0 0 0 0 0 0 0 0 0 0 0 0 0 0 0 0 0 0 0 0 0 0 0 0 0 0 50 47 51 
51 51 51 52 0 0 0 0 0 0 0 0 0 0 0 0 0 0 0 0 0 0 0 3 0 0 0 0 0 0 0 0 0 0 0 0 0 0 0 0 50 51 51 
51 51 47 52 0 0 0 0 0 0 0 0 0 0 0 0 0 0 0 0 0 48 41 41 41 41 41 49 0 0 0 0 0 0 0 0 0 0 0 0 50 51 51 
51 51 51 52 0 0 0 0 0 0 0 0 0 0 0 0 0 0 0 0 0 50 51 47 51 51 51 52 0 0 0 0 0 0 0 0 0 0 0 0 50 51 51 
51 51 51 52 0 0 0 0 0 0 0 0 0 0 0 0 0 0 0 0 0 50 51 51 51 51 51 52 0 0 0 0 0 0 0 0 0 0 0 0 50 51 47 
47 51 51 52 0 0 0 0 0 0 0 0 43 44 45 0 1 0 0 0 0 50 51 51 47 51 47 52 0 0 0 0 0 0 0 0 0 0 0 0 50 51 51 
51 51 51 52 0 0 0 0 0 0 0 0 50 47 52 48 41 41 41 41 49 50 47 51 51 51 47 52 0 0 0 0 0 0 0 0 0 0 0 0 50 51 51 
51 51 51 52 4 5 5 5 5 5 5 6 50 47 52 50 47 51 51 47 52 50 51 51 51 51 51 52 0 3 0 0 0 0 0 0 0 0 0 0 50 47 51 
51 51 51 51 41 41 41 41 41 41 41 41 41 41 41 41 41 41 41 41 41 41 41 41 41 41 41 41 41 45 0 0 0 0 0 0 0 0 0 0 50 51 51 
51 47 51 51 51 51 51 51 51 51 51 51 51 51 51 51 51 51 51 51 51 51 51 51 51 51 51 51 51 52 0 0 0 0 0 0 0 0 0 0 50 51 47 
51 51 51 51 51 47 51 51 51 51 51 51 47 51 51 51 51 51 47 51 51 51 51 51 47 51 51 51 51 52 0 0 0 0 0 0 0 0 0 0 50 51 47 
51 47 51 51 51 51 51 51 51 47 51 51 51 51 51 51 51 51 51 51 51 51 51 51 51 51 51 47 51 52 0 0 0 0 0 0 0 0 0 0 50 51 51 
51 51 51 47 51 51 51 51 51 51 51 51 51 51 51 51 51 51 51 51 51 51 51 51 51 51 51 51 51 51 41 41 41 41 41 41 41 41 41 41 50 51 51 
51 51 51 51 51 47 51 51 51 51 51 47 51 51 51 51 47 51 47 51 51 51 51 51 47 51 51 51 47 51 51 51 51 51 51 51 51 47 51 47 51 51 51 
51 51 51 51 51 51 51 51 51 51 51 51 51 51 51 51 51 51 51 51 51 51 51 51 51 51 51 51 51 51 51 51 51 47 51 51 51 51 51 51 51 51 51 
